20
35
7 7 7 7 7 7 7 7 0 0 e_Lagniez 0 0 8 8 8 8 8 8 8
7 7 7 7 7 7 7 7 0 0 0 0 0 8 8 8 8 8 8 8
7 7 7 7 7 7 7 7 0 0 0 0 e_Lonca 8 8 8 8 8 8 8
7 7 7 7 7 7 7 7 0 0 0 0 0 8 8 8 8 8 8 8
7 7 7 7 7 7 7 7 e_Mazure 0 0 0 0 8 8 8 8 8 8 8
7 7 7 7 7 7 7 7 0 0 0 0 0 8 8 8 8 8 8 8
7 7 7 0 0 0 0 0 0 0 0 0 0 0 0 0 0 0 8 8
7 7 n 0 0 0 0 0 0 0 0 0 0 0 0 0 0 0 8 8
7 7 7 0 0 0 0 0 0 0 0 0 0 0 0 0 0 0 8 8
7 7 7 0 0 0 9 9 9 9 9 9 9 9 9 0 0 0 8 8
7 7 7 0 0 0 9 9 9 9 9 9 9 9 n 0 0 0 8 8
0 0 0 0 0 0 9 9 9 9 9 9 9 9 9 0 0 0 8 8
0 0 0 0 0 0 9 9 9 10 10 10 9 9 9 0 0 0 8 8
6 6 6 0 0 0 9 9 9 10 10 10 9 9 9 0 0 0 8 8
6 6 6 0 0 0 9 9 9 10 10 10 9 9 9 0 0 0 8 8
6 6 6 0 0 0 9 9 9 9 9 9 9 9 9 0 0 0 0 0
6 6 6 0 0 0 9 9 9 9 9 9 9 9 9 0 0 0 0 0
6 6 6 0 0 0 9 9 9 9 9 9 9 9 9 0 0 0 3 3
6 6 6 0 0 0 0 0 0 0 0 0 0 0 0 0 0 0 3 3
6 6 6 0 0 0 0 0 0 0 0 0 0 0 0 0 0 0 3 3
6 6 6 0 0 0 0 0 0 0 0 0 0 0 0 0 0 0 3 3
6 6 6 0 0 4 4 4 4 4 0 5 5 5 5 5 0 0 3 3
0 0 0 0 0 4 4 4 4 4 0 5 5 5 5 5 0 0 3 3
0 0 0 0 0 4 4 4 4 4 0 5 5 5 5 5 0 0 3 3
3 3 3 0 0 4 4 4 4 4 0 5 5 5 5 5 0 0 3 3
3 3 3 0 0 4 4 4 4 4 0 5 5 5 5 5 0 0 0 0
3 3 3 0 0 4 4 4 4 4 0 5 5 5 5 5 0 0 0 0
3 3 3 0 0 0 0 0 0 0 0 0 0 0 0 0 0 0 1 1
3 3 3 0 0 0 0 0 0 0 0 0 0 0 0 0 0 0 1 1
3 3 3 0 0 1 1 1 1 1 1 1 0 0 1 1 1 1 1 1
0 0 0 0 0 1 1 1 1 1 1 1 0 0 1 2 2 2 1 1
0 0 0 0 0 1 1 1 1 1 1 1 0 0 1 2 2 2 1 1
1 1 1 1 1 1 2 2 2 2 1 1 0 0 1 2 2 2 1 1
1 2 2 2 2 2 2 2 2 2 1 1 0 0 n 2 2 2 1 1
1 1 1 1 1 1 1 1 1 1 1 1 0 0 1 1 1 1 1 1
